0 0 0 0 5 5 0 1 0 5 5 0 0 0 0
0 0 0 5 3 3 5 1 5 3 3 5 0 0 0
0 0 0 5 3 3 3 1 3 3 3 5 0 0 0
0 0 0 5 3 3 3 1 3 3 3 5 0 0 0
0 0 0 0 5 3 3 1 3 3 5 0 0 0 0
0 0 0 0 0 5 3 1 3 5 0 0 0 0 0
0 0 0 0 0 0 5 1 5 0 0 0 0 0 0
0 0 0 0 0 0 0 1 0 0 0 0 0 0 0